C	C
a	a
p	p
u	u
h	h
q	q
i	i
S	S
w	w
N	N
m	m
b	b
k	k
n	n
l	l
ŋ	ŋ
e	e
z	z
s	s
R	R
j	j
g	g
d	d
y	y
r	r
t	t
D	D
ñ	ñ
ʔ	ʔ
á	á
c	c
ə	ə
