a	a
b	b
d	d
i	i
m	m
n	n
t	t
bh	bh
ā	ā
p	p
v	v
s	s
r	r
ī	ī
ṭ	ṭ
c	c
h	h
dh	dh
u	u
y	y
gh	gh
g	g
j	j
k	k
e	e
th	th
o	o
ñ	ñ
ū	ū
ḍ	ḍ
kh	kh
l	l
<unk>	<unk>
