a	a
i	i
s	s
th	th
n	n
o	o
m	m
ē	ē
kh	kh
r	r
t	t
e	e
ō	ō
l	l
u	u
h	h
ū	ū
b	b
p	p
d	d
ī	ī
g	g
k	k
ph	ph
z	z
ā	ā
ai	ai
ōi	ōi
ēi	ēi
<unk>	<unk>
